NO assets/textures/north_texture.xpm
SO assets/textures/south_texture.xpm
WE assets/textures/west_texture.xpm
EA assets/textures/east_texture.xpm
F 139,69,19
C 173,216,227

1111111111111101111111111
1000000000000000000000001
1000000000000000000000001
1000000000000000000000001
1111111111110111111111111
1000000000000000000000001
1000000000000000000000001
1000000000000000000000001
1000000000000000000000001
1000000000N00000000000001
1000000000000000000000001
1000000000000000000000001
1000000000000000000000001
1000000000000000000000001
1000000000000000000000001
1111111111111111111111111
